# Special
EIC="countries/East India Company.txt"
REB="countries/rebels.txt"
UTI="countries/Utility Tag.txt"

# North Africa
ALD="countries/Aldjazair.txt"
CYR="countries/Cyrenaica.txt"
EGY="countries/Egypt.txt"
LBY="countries/Libya.txt"
MGH="countries/Maghreb.txt"
MOR="countries/Morocco.txt"
TRI="countries/Tripoli.txt"
TUN="countries/Tunis.txt"

# East Africa
AWS="countries/Awsa.txt"
BRD="countries/Urundi.txt"
BUG="countries/Buganda.txt"
DAR="countries/Darfur.txt"
ETH="countries/Ethiopia.txt"
GEL="countries/Geledi.txt"
GON="countries/Gonder.txt"
HAR="countries/Harar.txt"
HBY="countries/Hobyo.txt"
KAF="countries/Kaffa.txt"
KNY="countries/Kenya.txt"
MAJ="countries/Majeerteen.txt"
RWA="countries/Ruanda.txt"
SHK="countries/Shilluk.txt"
SHW="countries/Shewa.txt"
SOM="countries/Somalia.txt"
SUD="countries/Sudan.txt"
TIG="countries/Tigray.txt"
TNZ="countries/Tanzania.txt"
WRL="countries/Warsangali.txt"
ZAN="countries/Zanzibar.txt"

# Southern Africa
AGC="countries/Angoche.txt"
ANG="countries/Angola.txt"
BSH="countries/Basotho.txt"
CMS="countries/Comoros.txt"
GAZ="countries/Gaza.txt"
MAD="countries/Madagascar.txt"
MAT="countries/Matabele.txt"
MOZ="countries/Mozambique.txt"
NAL="countries/Natalia.txt"
NMB="countries/Namibia.txt"
ORA="countries/Oranje.txt"
RHO="countries/Southern Rhodesia.txt"
SAF="countries/South Africa.txt"
SUA="countries/Suazi.txt"
TRN="countries/Transvaal.txt"
TSW="countries/Botswana.txt"
XHO="countries/Xhosa.txt"
ZAM="countries/Zambia.txt"
ZUL="countries/Zulu.txt"

# Central Africa
AZA="countries/Azande.txt"
CAR="countries/Central African Republic.txt"
CGO="countries/Congo-Brazzaville.txt"
CHD="countries/Chad.txt"
CMR="countries/Cameroon.txt"
CNG="countries/Congo Free State.txt"
EQG="countries/Equatorial Guinea.txt"
GAB="countries/Gabon.txt"
KON="countries/Kongo.txt"
KUB="countries/Kuba.txt"
KZB="countries/Kazembe.txt"
LBA="countries/Luba.txt"
LOA="countries/Loango.txt"
LUN="countries/Lunda.txt"
MLW="countries/Malawi.txt"
MNG="countries/Mongo.txt"
SHO="countries/Shona.txt"
SID="countries/Sidama.txt"
WAD="countries/Wadai.txt"

# West Africa
ARO="countries/Aro.txt"
ASH="countries/Ashanti.txt"
BEN="countries/Benin.txt"
BKF="countries/Burkina Faso.txt"
CLA="countries/Calabar.txt"
DAH="countries/Dahomey.txt"
DAM="countries/Damagaram.txt"
DND="countries/Dendi.txt"
GBU="countries/Gabu.txt"
GHN="countries/Ghana.txt"
GMB="countries/Gambia.txt"
IVC="countries/Ivory Coast.txt"
JAL="countries/Jallon.txt"
KBO="countries/Kanem-Bornu.txt"
KNG="countries/Kong.txt"
LIB="countries/Liberia.txt"
MAS="countries/Massina.txt"
MLI="countries/Mali.txt"
MOS="countries/Mossi.txt"
NGR="countries/Nigeria.txt"
NIG="countries/Niger.txt"
OYO="countries/Oyo.txt"
SEG="countries/Segu.txt"
SLE="countries/Sierra Leone.txt"
SNG="countries/Senegal.txt"
SOK="countries/Sokoto.txt"
TOG="countries/Togo.txt"
TOO="countries/Tooro.txt"
TOU="countries/Toucouleur.txt"
TRZ="countries/Trarza.txt"
WOL="countries/Wolof.txt"
WRI="countries/Warri.txt"

# Northern America
CAL="countries/Californian Republic.txt"
CAN="countries/Canada.txt"
CHE="countries/Cherokee.txt"
COL="countries/Columbia.txt"
CSA="countries/CSA.txt"
DAK="countries/Dakota.txt"
DES="countries/Deseret.txt"
FSA="countries/Free States of America.txt"
GRN="countries/Greenland.txt"
LSK="countries/Alaska.txt"
MRU="countries/Maritime Union.txt"
MTC="countries/Metis Confederacy.txt"
NEN="countries/New England.txt"
NEW="countries/Newfoundland.txt"
QUE="countries/Quebec.txt"
RPL="countries/Rupert's Land.txt"
TEX="countries/Texas.txt"
UIL="countries/Illinois.txt"
UNB="countries/Nebraska.txt"
UNM="countries/New Mexico.txt"
UOR="countries/Oregon.txt"
USA="countries/USA.txt"

# Middle America
ATC="countries/Antillean Conf.txt"
BAH="countries/Bahia.txt"
BLZ="countries/Belize.txt"
CHP="countries/Chiapas.txt"
COS="countries/Costa Rica.txt"
CUB="countries/Cuba.txt"
DOM="countries/Dominican Republic.txt"
ELS="countries/El Salvador.txt"
GUA="countries/Guatemala.txt"
HAI="countries/Haiti.txt"
HON="countries/Honduras.txt"
JAM="countries/Jamaica.txt"
LOS="countries/Los Altos.txt"
MEX="countries/Mexico.txt"
NIC="countries/Nicaragua.txt"
PNM="countries/Panama.txt"
PRI="countries/Puerto Rico.txt"
RGR="countries/Rio Grande.txt"
SON="countries/Sonora.txt"
TTB="countries/Trinidad.txt"
UCA="countries/United States of Central America.txt"
YUC="countries/Yucatan.txt"

# South America
ARC="countries/Argentine Conf.txt"
ARG="countries/Argentina.txt"
BOL="countries/Bolivia.txt"
BRZ="countries/Brazil.txt"
CEQ="countries/Equador Confederation.txt"
CHL="countries/Chile.txt"
CLM="countries/Colombia.txt"
CRT="countries/Corrientes.txt"
ECU="countries/Ecuador.txt"
ENT="countries/Entre Rios.txt"
GCO="countries/Gran Colombia.txt"
GUY="countries/Guyana.txt"
LPL="countries/La Plata.txt"
PBC="countries/Peru-Bolivia Confederation.txt"
PEU="countries/Peru.txt"
PNB="countries/Pernambuco.txt"
PRG="countries/Paraguay.txt"
PTG="countries/Patagonia.txt"
RGS="countries/Rio Grande do Sul.txt"
SBA="countries/Buenos Aires.txt"
SPU="countries/South Peru.txt"
URU="countries/Uruguay.txt"
VNZ="countries/Venezuela.txt"

# North Asia
ALT="countries/Altai Republic.txt"
BRY="countries/Buryatia.txt"
KAM="countries/Kamchatka.txt"
KMK="countries/Kalmykia.txt"
SIB="countries/Siberian Republic.txt"
TNT="countries/Tannu Tuva.txt"
URA="countries/Ural Republic.txt"
YAK="countries/Yakutia.txt"

# East Asia
CHI="countries/China.txt"
CHO="countries/Choshu.txt"
EZO="countries/EzoRep.txt"
FJN="countries/Fujian.txt"
GMJ="countries/Guominjun.txt"
GNG="countries/Guangdong.txt"
GXI="countries/Guangxi Clique.txt"
HNN="countries/Hunan.txt"
HUI="countries/Anhui.txt"
JAP="countries/Japan.txt"
KAG="countries/Kaga.txt"
KML="countries/Kumul.txt"
KMT="countries/Nationalist China.txt"
KOR="countries/Korea.txt"
MCK="countries/Manchukuo.txt"
MGL="countries/Mongolia.txt"
PGG="countries/Pingnan Guo.txt"
QNG="countries/Qing China.txt"
RYU="countries/Ryukyu.txt"
SAT="countries/Satsuma.txt"
SEN="countries/Sendai.txt"
SXI="countries/Shanxi.txt"
SZC="countries/Sichuan.txt"
TAI="countries/Taiwan.txt"
TIB="countries/Tibet.txt"
TKG="countries/Shogunate Japan.txt"
TOS="countries/Tosa.txt"
TPG="countries/Taiping.txt"
UYG="countries/Uyghurstan.txt"
XBI="countries/Xibei San Ma.txt"
XIN="countries/Xinjiang.txt"
YNN="countries/Yunnan.txt"
YZW="countries/Yonezawa.txt"

# Southeast Asia
ATJ="countries/Atjeh.txt"
BAL="countries/Bali.txt"
BRU="countries/Brunei.txt"
BUR="countries/Burma.txt"
CAM="countries/Cambodia.txt"
CHK="countries/Champasak.txt"
DAI="countries/Dai Viet.txt"
DJA="countries/Jambi.txt"
INO="countries/Indonesia.txt"
JAV="countries/Java.txt"
JOH="countries/Johore.txt"
KAR="countries/Karen.txt"
KCH="countries/Kachin.txt"
KLM="countries/Kalimantan.txt"
KTI="countries/Kutai.txt"
LAN="countries/Lanfang.txt"
LUA="countries/Luang Prabang.txt"
LXA="countries/Lan Xang.txt"
MAL="countries/Maluku.txt"
MLY="countries/Malaya.txt"
PHG="countries/Pahang.txt"
PHL="countries/Philippines.txt"
PNK="countries/Pontianak.txt"
PRK="countries/Perak.txt"
SAK="countries/Siak.txt"
SHA="countries/Shan.txt"
SIA="countries/Siam.txt"
SLG="countries/Selangor.txt"
SLW="countries/Sulawesi.txt"
SUL="countries/Sulu.txt"
SWK="countries/Sarawak.txt"
TMR="countries/Timor.txt"
WIA="countries/Wiang Chhan.txt"

# South Asia
ASM="countries/Assam.txt"
AWA="countries/Awadh.txt"
BAS="countries/Bastar.txt"
BER="countries/Beroda.txt"
BHO="countries/Bhopal.txt"
BHP="countries/Bahawalpur.txt"
BHU="countries/Bhutan.txt"
BIH="countries/Bihar.txt"
BIK="countries/Bikaner.txt"
BNG="countries/Bengal.txt"
BUN="countries/Bundelkhand.txt"
DRA="countries/Dravidistan.txt"
GWA="countries/Gwailor.txt"
HND="countries/India.txt"
HYD="countries/Hyderabad.txt"
IND="countries/Indore.txt"
JAI="countries/Jaipur.txt"
JAS="countries/Jaisalmer.txt"
JOD="countries/Jodhpur.txt"
KAS="countries/Kashmir.txt"
KRN="countries/Karnatak.txt"
KUT="countries/Kutch.txt"
LAD="countries/Ladakh.txt"
MAH="countries/Maharashtra.txt"
MEW="countries/Mewar.txt"
MLD="countries/Maldives.txt"
MNP="countries/Manipur.txt"
MUG="countries/Mughalistan.txt"
MYS="countries/Mysore.txt"
NAG="countries/Nagpur.txt"
NEP="countries/Nepal.txt"
ORI="countries/Orissa.txt"
PAK="countries/Pakistan.txt"
PNJ="countries/Panjab.txt"
RAJ="countries/Rajputana.txt"
SHI="countries/Shimla.txt"
SIK="countries/Sikkim.txt"
SIN="countries/Sind.txt"
SRI="countries/Sri Lanka.txt"
TRA="countries/Travancore.txt"

# Central Asia
BDK="countries/Badakhshan.txt"
BUK="countries/Bukkhara.txt"
KAZ="countries/Kazakhstan.txt"
KHI="countries/Khiva.txt"
KOK="countries/Kokand.txt"
KYR="countries/Kyrgyzstan.txt"
TAJ="countries/Tajikstan.txt"
TKM="countries/Turkmenistan.txt"
TKS="countries/Turkestan.txt"
UZB="countries/Uzbekistan.txt"

# Iranian Plateau
AFG="countries/Afghanistan.txt"
BLC="countries/Baluchistan.txt"
CRL="countries/Chitral.txt"
DUR="countries/Durrani Empire.txt"
KAL="countries/Kalat.txt"
MAK="countries/Makran.txt"
PER="countries/Persia.txt"

# Kurdistan
BDN="countries/Bahdinan.txt"
BHT="countries/Bohtan.txt"
BNB="countries/Baban.txt"
BTL="countries/Bitlis.txt"
KDS="countries/Kurdistan.txt"
MKN="countries/Mukriyan.txt"
RDL="countries/Ardalan.txt"
SRN="countries/Soran.txt"

# Transcaucasia
ABK="countries/Abkhazia.txt"
ARM="countries/Armenia.txt"
AZB="countries/Azerbaijan.txt"
GEO="countries/Georgia.txt"
TCA="countries/Transcaucasia.txt"

# Anatolia
CLC="countries/Cilicia.txt"
PNT="countries/Pontus.txt"

# Levant
ASY="countries/Assyria.txt"
BAB="countries/Babylonia.txt"
CYP="countries/Cyprus.txt"
HTY="countries/Hatay.txt"
IRQ="countries/Iraq.txt"
ISR="countries/Israel.txt"
JOR="countries/Jordan.txt"
KWT="countries/Kuwait.txt"
LBN="countries/Lebanon.txt"
PLS="countries/Palestine.txt"
SYR="countries/Syria.txt"

# Arabia
ABU="countries/Abu Dhabi.txt"
ARA="countries/Arabia.txt"
ARU="countries/Arab Union.txt"
BHR="countries/Bahrain.txt"
FDL="countries/Fadhli.txt"
HAL="countries/Hail.txt"
HDJ="countries/Hedjaz.txt"
KTH="countries/Kathiri.txt"
LHJ="countries/Lahej.txt"
MHR="countries/Mahra.txt"
NEJ="countries/Nejd.txt"
NYE="countries/North Yemen.txt"
OMA="countries/Oman.txt"
QAT="countries/Qatar.txt"
YEM="countries/Yemen.txt"

# Northern Europe
DEN="countries/Denmark.txt"
FIN="countries/Finland.txt"
FRO="countries/Faroe.txt"
ICL="countries/Iceland.txt"
KRL="countries/Karelia.txt"
NOR="countries/Norway.txt"
SCA="countries/Scandinavia.txt"
SCH="countries/Schleswig.txt"
SWE="countries/Sweden.txt"
SWH="countries/Schleswig-Holstein.txt"

# Western Europe
ALS="countries/Elsass.txt"
ATR="countries/Asturias.txt"
BEL="countries/Belgium.txt"
BRT="countries/Brittany.txt"
BSQ="countries/Basqueland.txt"
CAT="countries/Catalonia.txt"
DLM="countries/Dalmatia.txt"
ENG="countries/United Kingdom.txt"
ENL="countries/England.txt"
FLA="countries/Flanders.txt"
FRA="countries/France.txt"
IBR="countries/Iberia.txt"
IRE="countries/Ireland.txt"
LOR="countries/Lorraine.txt"
MCD="countries/Macedonia.txt"
NEH="countries/Neuchatel Canton.txt"
NET="countries/Netherlands.txt"
OCC="countries/Occitania.txt"
POR="countries/Portugal.txt"
SCO="countries/Scotland.txt"
SPA="countries/Spain.txt"
SPC="countries/Carlist Spain.txt"
SWI="countries/Switzerland.txt"
WHA="countries/Wales.txt"
WLL="countries/Wallonia.txt"

# German Confederation
ANH="countries/Anhalt.txt"
AUS="countries/Austria.txt"
BAD="countries/Baden.txt"
BAV="countries/Bavaria.txt"
BOH="countries/Bohemia-Moravia.txt"
BRA="countries/Braunschweig.txt"
BRE="countries/Bremen.txt"
COB="countries/Saxe-Coburg-Gotha.txt"
DNB="countries/Danubian Federation.txt"
FRM="countries/Frankfurt am Main.txt"
GER="countries/Germany.txt"
HAM="countries/Hamburg.txt"
HAN="countries/Hanover.txt"
HEK="countries/Hesse-Kassel.txt"
HES="countries/Hesse-Darmstadt.txt"
HOL="countries/Holstein.txt"
KUK="countries/Austria-Hungary.txt"
LBG="countries/Limburg.txt"
LIP="countries/Lippe-Detmold.txt"
LUB="countries/Lubeck.txt"
LUX="countries/Luxemburg.txt"
LUZ="countries/Luzica.txt"
MEC="countries/Mecklenburg.txt"
MEI="countries/Saxe-Meiningen.txt"
NAS="countries/Nassau.txt"
NGF="countries/North German Fed.txt"
OLD="countries/Oldenburg.txt"
PRU="countries/Prussia.txt"
RHI="countries/Rhineland.txt"
SAX="countries/Saxony.txt"
SGF="countries/South German Fed.txt"
SGM="countries/Sigmaringen-Hohe.txt"
SLS="countries/Silesia.txt"
WEI="countries/Saxe-Weimar.txt"
WES="countries/Westfalen.txt"
WUR="countries/Wurttemberg.txt"

# Italy
CRS="countries/Corsica.txt"
ITA="countries/Italy.txt"
LOM="countries/Lombardia.txt"
LUC="countries/Lucca.txt"
MLT="countries/Malta.txt"
MOD="countries/Modena.txt"
PAP="countries/Papal States.txt"
PAR="countries/Parma.txt"
RMG="countries/Romagna.txt"
SAR="countries/Sardinia-Piedmont.txt"
SIC="countries/Two Sicilies.txt"
SRD="countries/Sardinia.txt"
SVY="countries/Savoy.txt"
SYC="countries/Sicily.txt"
TRE="countries/Trieste.txt"
TUS="countries/Tuscany.txt"
VEN="countries/Venice.txt"

# Eastern Europe
AKH="countries/Astrakhan.txt"
BAN="countries/Banat.txt"
BKV="countries/Bukovina.txt"
BYE="countries/Belarus.txt"
CHY="countries/Chechnya.txt"
CIR="countries/Circassia.txt"
CPL="countries/Congress Poland.txt"
CRI="countries/Crimea.txt"
CZH="countries/Czechoslovakia.txt"
DAG="countries/Dagestan.txt"
DON="countries/Cossackia.txt"
DZG="countries/Danzig.txt"
EST="countries/Estonia.txt"
GLC="countries/Galicia.txt"
GLM="countries/Galicia-Lodomeria.txt"
HUN="countries/Hungary.txt"
IZH="countries/Ingria.txt"
KRA="countries/Krakow.txt"
LAT="countries/Latvia.txt"
LIT="countries/Lithuania.txt"
MDV="countries/Moldova.txt"
PLC="countries/Poland-Lithuania.txt"
PML="countries/Pomerelia.txt"
POL="countries/Poland.txt"
PZN="countries/Poznan.txt"
ROM="countries/Romania.txt"
RUS="countries/Russia.txt"
RUT="countries/Ruthenia.txt"
SIE="countries/Siebenburgen.txt"
SLV="countries/Slovakia.txt"
TAR="countries/Tatarstan.txt"
UBD="countries/United Baltic Provinces.txt"
UKR="countries/Ukraine.txt"
VRP="countries/Volga Republic.txt"

# Balkans
ALB="countries/Albania.txt"
BOS="countries/Bosnia-Herzegovina.txt"
BUL="countries/Bulgaria.txt"
BYZ="countries/Byzantium.txt"
CRE="countries/Crete.txt"
CRO="countries/Croatia.txt"
FIU="countries/Fiume.txt"
GRE="countries/Greece.txt"
ION="countries/Ionian Islands.txt"
MOL="countries/Moldavia.txt"
MON="countries/Montenegro.txt"
SER="countries/Serbia.txt"
SLO="countries/Slovenia.txt"
TUR="countries/Ottoman Empire.txt"
WAL="countries/Wallachia.txt"
YUG="countries/Yugoslavia.txt"

# Oceania
AOT="countries/Aotearoa.txt"
AST="countries/Australia.txt"
FIJ="countries/Fiji.txt"
HAW="countries/Hawaii.txt"
NZL="countries/New Zealand.txt"
PPG="countries/Papua New Guinea.txt"
SMO="countries/Samoa.txt"
SNZ="countries/South Island.txt"
TGA="countries/Tonga.txt"
TMT="countries/Tuamotu.txt"
VTU="countries/Vanuatu.txt"

dynamic_tags=yes
# Dynamic Dominions
D01="countries/D01.txt"
D02="countries/D02.txt"
D03="countries/D03.txt"
D04="countries/D04.txt"
D05="countries/D05.txt"
D06="countries/D06.txt"
D07="countries/D07.txt"
D08="countries/D08.txt"
D09="countries/D09.txt"
D10="countries/D10.txt"
D11="countries/D11.txt"
D12="countries/D12.txt"
D13="countries/D13.txt"
D14="countries/D14.txt"
D15="countries/D15.txt"
D16="countries/D16.txt"
D17="countries/D17.txt"
D18="countries/D18.txt"
D19="countries/D19.txt"
D20="countries/D20.txt"
D21="countries/D21.txt"
D22="countries/D22.txt"
D23="countries/D23.txt"
D24="countries/D24.txt"
D25="countries/D25.txt"
D26="countries/D26.txt"
D27="countries/D27.txt"
D28="countries/D28.txt"
D29="countries/D29.txt"
D30="countries/D30.txt"
D31="countries/D31.txt"
D32="countries/D32.txt"
D33="countries/D33.txt"
D34="countries/D34.txt"
D35="countries/D35.txt"
D36="countries/D36.txt"
D37="countries/D37.txt"
D38="countries/D38.txt"
D39="countries/D39.txt"
D40="countries/D40.txt"
D41="countries/D41.txt"
D42="countries/D42.txt"
D43="countries/D43.txt"
D44="countries/D44.txt"
D45="countries/D45.txt"
D46="countries/D46.txt"
D47="countries/D47.txt"
D48="countries/D48.txt"
D49="countries/D49.txt"
D50="countries/D50.txt"
